[
  {
    "Id": 0,
    "Price": [ 0.0, 12.5, 15.0, 17.5 ],
    "Seats": [
      [ 0, 0, 1, 1, 1, 1, 1, 1, 1, 1, 0, 0 ],
      [ 0, 0, 1, 1, 1, 1, 1, 1, 1, 1, 0, 0 ],
      [ 0, 1, 1, 1, 1, 1, 1, 1, 1, 1, 1, 0 ],
      [ 1, 1, 1, 1, 1, 2, 2, 1, 1, 1, 1, 1 ],
      [ 1, 1, 1, 1, 2, 2, 2, 2, 1, 1, 1, 1 ],
      [ 1, 1, 1, 2, 2, 3, 3, 2, 2, 1, 1, 1 ],
      [ 1, 1, 1, 2, 2, 3, 3, 2, 2, 1, 1, 1 ],
      [ 1, 1, 1, 2, 2, 3, 3, 2, 2, 1, 1, 1 ],
      [ 1, 1, 1, 2, 2, 3, 3, 2, 2, 1, 1, 1 ],
      [ 1, 1, 1, 1, 2, 2, 2, 2, 1, 1, 1, 1 ],
      [ 1, 1, 1, 1, 1, 2, 2, 1, 1, 1, 1, 1 ],
      [ 0, 1, 1, 1, 1, 1, 1, 1, 1, 1, 1, 0 ],
      [ 0, 1, 1, 1, 1, 1, 1, 1, 1, 1, 1, 0 ],
      [ 0, 0, 1, 1, 1, 1, 1, 1, 1, 1, 0, 0 ]
    ]
  },
  {
    "Id": 1,
    "Price": [ 0.0, 12.5, 15.0, 17.5 ],
    "Seats": [
      [ 0, 0, 0, 1, 1, 1, 1, 1, 1, 1, 1, 1, 1, 1, 1, 0, 0, 0 ],
      [ 0, 0, 0, 1, 1, 1, 1, 1, 1, 1, 1, 1, 1, 1, 1, 0, 0, 0 ],
      [ 0, 0, 1, 1, 1, 1, 1, 1, 1, 1, 1, 1, 1, 1, 1, 1, 0, 0 ],
      [ 0, 0, 1, 1, 1, 1, 2, 2, 2, 2, 2, 2, 1, 1, 1, 1, 0, 0 ],
      [ 0, 0, 1, 1, 1, 1, 2, 2, 2, 2, 2, 2, 1, 1, 1, 1, 0, 0 ],
      [ 0, 1, 1, 1, 1, 2, 2, 2, 2, 2, 2, 2, 2, 1, 1, 1, 1, 0 ],
      [ 0, 1, 1, 1, 2, 2, 2, 2, 3, 3, 2, 2, 2, 2, 1, 1, 1, 0 ],
      [ 0, 1, 1, 2, 2, 2, 2, 3, 3, 3, 3, 2, 2, 2, 2, 1, 1, 0 ],
      [ 1, 1, 2, 2, 2, 2, 3, 3, 3, 3, 3, 3, 2, 2, 2, 2, 1, 1 ],
      [ 1, 1, 2, 2, 2, 2, 3, 3, 3, 3, 3, 3, 2, 2, 2, 2, 1, 1 ],
      [ 1, 1, 2, 2, 2, 2, 3, 3, 3, 3, 3, 3, 2, 2, 2, 2, 1, 1 ],
      [ 1, 1, 1, 2, 2, 2, 3, 3, 3, 3, 3, 3, 2, 2, 2, 1, 1, 1 ],
      [ 1, 1, 1, 2, 2, 2, 2, 3, 3, 3, 3, 2, 2, 2, 2, 1, 1, 1 ],
      [ 0, 1, 1, 1, 2, 2, 2, 2, 3, 3, 2, 2, 2, 2, 1, 1, 1, 0 ],
      [ 0, 1, 1, 1, 2, 2, 2, 2, 2, 2, 2, 2, 2, 2, 1, 1, 1, 0 ],
      [ 0, 1, 1, 1, 1, 2, 2, 2, 2, 2, 2, 2, 2, 1, 1, 1, 1, 0 ],
      [ 0, 1, 1, 1, 1, 2, 2, 2, 2, 2, 2, 2, 2, 1, 1, 1, 1, 0 ],
      [ 0, 1, 1, 1, 1, 1, 2, 2, 2, 2, 2, 2, 1, 1, 1, 1, 1, 0 ],
      [ 0, 1, 1, 1, 1, 1, 1, 1, 1, 1, 1, 1, 1, 1, 1, 1, 1, 0 ]
    ]
  },
  {
    "Id": 2,
    "Price": [ 0.0, 12.5, 15.0, 17.5 ],
    "Seats": [
      [ 0, 0, 0, 0, 0, 0, 0, 0, 1, 1, 1, 1, 1, 1, 1, 1, 1, 1, 1, 1, 1, 1, 0, 0, 0, 0, 0, 0, 0, 0 ],
      [ 0, 0, 0, 0, 0, 0, 0, 1, 1, 1, 1, 1, 1, 1, 1, 1, 1, 1, 1, 1, 1, 1, 1, 0, 0, 0, 0, 0, 0, 0 ],
      [ 0, 0, 0, 0, 0, 1, 1, 1, 1, 1, 1, 1, 1, 1, 1, 1, 1, 1, 1, 1, 1, 1, 1, 1, 1, 0, 0, 0, 0, 0 ],
      [ 0, 0, 0, 1, 1, 1, 1, 1, 1, 1, 1, 2, 2, 2, 2, 2, 2, 2, 2, 1, 1, 1, 1, 1, 1, 1, 1, 0, 0, 0 ],
      [ 0, 0, 0, 1, 1, 1, 1, 1, 1, 2, 2, 2, 2, 2, 2, 2, 2, 2, 2, 2, 2, 1, 1, 1, 1, 1, 1, 0, 0, 0 ],
      [ 0, 0, 1, 1, 1, 1, 1, 1, 2, 2, 2, 2, 2, 2, 2, 2, 2, 2, 2, 2, 2, 2, 1, 1, 1, 1, 1, 1, 0, 0 ],
      [ 0, 0, 1, 1, 1, 1, 1, 1, 2, 2, 2, 2, 2, 2, 2, 2, 2, 2, 2, 2, 2, 2, 1, 1, 1, 1, 1, 1, 0, 0 ],
      [ 0, 1, 1, 1, 1, 1, 1, 1, 2, 2, 2, 2, 2, 3, 3, 3, 3, 2, 2, 2, 2, 2, 1, 1, 1, 1, 1, 1, 1, 0 ],
      [ 1, 1, 1, 1, 1, 1, 1, 2, 2, 2, 2, 3, 3, 3, 3, 3, 3, 3, 3, 2, 2, 2, 2, 1, 1, 1, 1, 1, 1, 1 ],
      [ 1, 1, 1, 1, 1, 1, 2, 2, 2, 2, 2, 3, 3, 3, 3, 3, 3, 3, 3, 2, 2, 2, 2, 2, 1, 1, 1, 1, 1, 1 ],
      [ 1, 1, 1, 1, 1, 2, 2, 2, 2, 2, 2, 3, 3, 3, 3, 3, 3, 3, 3, 2, 2, 2, 2, 2, 2, 1, 1, 1, 1, 1 ],
      [ 1, 1, 1, 1, 1, 2, 2, 2, 2, 2, 2, 3, 3, 3, 3, 3, 3, 3, 3, 2, 2, 2, 2, 2, 2, 1, 1, 1, 1, 1 ],
      [ 1, 1, 1, 1, 1, 1, 2, 2, 2, 2, 2, 3, 3, 3, 3, 3, 3, 3, 3, 2, 2, 2, 2, 2, 1, 1, 1, 1, 1, 1 ],
      [ 0, 1, 1, 1, 1, 1, 2, 2, 2, 2, 2, 3, 3, 3, 3, 3, 3, 3, 3, 2, 2, 2, 2, 2, 1, 1, 1, 1, 1, 0 ],
      [ 0, 0, 1, 1, 1, 1, 1, 2, 2, 2, 2, 2, 3, 3, 3, 3, 3, 3, 2, 2, 2, 2, 2, 1, 1, 1, 1, 1, 0, 0 ],
      [ 0, 0, 0, 1, 1, 1, 1, 2, 2, 2, 2, 2, 2, 3, 3, 3, 3, 2, 2, 2, 2, 2, 2, 1, 1, 1, 1, 0, 0, 0 ],
      [ 0, 0, 0, 1, 1, 1, 1, 1, 2, 2, 2, 2, 2, 2, 2, 2, 2, 2, 2, 2, 2, 2, 1, 1, 1, 1, 1, 0, 0, 0 ],
      [ 0, 0, 0, 1, 1, 1, 1, 1, 2, 2, 2, 2, 2, 2, 2, 2, 2, 2, 2, 2, 2, 2, 1, 1, 1, 1, 1, 0, 0, 0 ],
      [ 0, 0, 0, 1, 1, 1, 1, 1, 1, 2, 2, 2, 2, 2, 2, 2, 2, 2, 2, 2, 2, 1, 1, 1, 1, 1, 1, 0, 0, 0 ],
      [ 0, 0, 0, 0, 1, 1, 1, 1, 1, 1, 1, 1, 1, 1, 1, 1, 1, 1, 1, 1, 1, 1, 1, 1, 1, 1, 0, 0, 0, 0 ]
    ]
  }
]

